 0  0  0  1 12  1  0  0  0  1 12  1  0  0  0
 0 12  0  4  4  4  0  4  0  4  4  4  0  4  0
 0 12  0  0  0  0  0  4  0  0  0  0  0  4  0
 0  7  4  4  0  4  0  4  0  4  0  4  4  4  0
 0  0  1  4  0  4  0  4  0  4  0  4  1  0  0
 0 10  4  4  0  4  0  4  0  4  0  4  4  4  0
 0 12  0  0  0  4  0  0  0  4  0  0  0  4  0
 0  0  0  4  0  4  0  4  0  4  0  4  0  0  0
 0 10  4  4  1  0  0  4  0  0  1  4  4  4  0
 0 12  1  4  4  4  0  4  0  4  4  4  1  4  0
 0 12  0  4  0  0  0  0  0  0  0  4  0  4  0
 0  0  0  4  0  4  4  4  4  4  0  4  0  0  0
 0 12  0  0  0  0  0  0  0  0  0  0  0  4  0
 0  7  4  4  4  0  4  4  4  0  4  4  4  4  0
 0  1  4  1  0  0  1  4  1  0  0  1  4  1  0