 0  0  0  1 14  1  0  0  0  1 14  1  0  0  0
 0 14  0  4  8  6  0 14  0  4  8  6  0 14  0
 0 12  0  0  0  0  0 12  0  0  0  0  0 12  0
 0  7  5 11  0 14  0 12  0 14  0 10  5  9  0
 0  0  1 12  0 12  0 12  0 12  0 12  1  0  0
 0 10  5  9  0 12  0 13  0 12  0  7  5 11  0
 0 13  0  0  0 12  0  0  0 12  0  0  0 13  0
 0  0  0 14  0 13  0 14  0 13  0 14  0  0  0
 0 10  5 15  1  0  0 12  0  0  1 16  5 11  0
 0 12  1 16  5  6  0 13  0  4  5 15  1 12  0
 0 13  0 12  0  0  0  0  0  0  0 12  0 13  0
 0  0  0 13  0  4  5  5  5  6  0 13  0  0  0
 0 14  0  0  0  0  0  0  0  0  0  0  0 14  0
 0  7 17  5  6  0  4 17  6  0  4  5 17  9  0
 0  1 13  1  0  0  1 13  1  0  0  1 13  1  0